0 0 100 0 0 0 0 0 0 0 0
0 0 70 0 0 0 0 0 0 0 0
0 0 30 0 0 0 0 0 0 0 0
0 0 30 0 0 100 0 0 0 0 0
0 0 30 0 0 100 100 0 0 0 0
0 0 50 0 0 100 0 0 0 0 0
0 0 30 0 0 100 0 0 0 0 0
0 0 79 0 0 0 0 0 0 0 0